Level 2
5
WWWWWWWWWWWWWWWWWWWWWWWWWWW
WPSSSSRSSSSSSSSSRSSSSS SSDW
WSSSSSSSSSSSSSSRDRSSSSSSSSW
WSSSSSR SSSSSSSDRRSSSSSSSSW
WSSSSDSSSSRSSSSSSSSSSSSSSSW
WSSSWWWWWWWWWWWWWWWWWWWWWWW
WSSSSSSSSSRSSSSSSSSSSSSRSSW
WSSRSSSDSSRSSSSSSS SSSSSSSW
WSSSSSSSSSSS SDSSSSSSSSSSSW
WWWWWWWWWWWSSSSDSSSSSDSSSSW
WSSRSSSDSSSSDSSSSSSSRSSESSW
WWWWWWWWWWWWWWWWWWWWWWWWWWW