Level 3
5
WWWWWWWWWWW
WDRSSSSSSPW
WRSRSSS SSW
WSRSSSSSSSW
WSSSSDSSSSW
WSSSSSSSSSW
WSSSSSSDSSW
WDSSSSSSRSW
WSSRSSSSSSW
WSSDSESDSSW
WWWWWWWWWWW