Level 1
5
WWWWWWWWWWWWWWWWWWWWWWWWWWW
WPSSSSRSSSSSSSSSRSSSSS SSDW
WSSSSSSSSSSSSSSRDRSSSSSSSSW
WSSSSSR SSSSSSSDRRSSSSSSSSW
WSSSSDSSSSRSSSSSSSSSSSSSSSW
WSSSSSSSSSRSSSSSSSSSSSSRSSW
WSSRSSSDSSRSSSSSSS SSSSSSSW
WSSSSSSSSSSS SDSSSSSSSSSSSW
WSSSDSSSSSSSSSSDSSSSSDSSSSW
WSSRSSSDSSSSDSSSSSSSRSSESSW
WWWWWWWWWWWWWWWWWWWWWWWWWWW